A64_A4x4_tet_5mm_150_200_121:
	
	  43    48    54    52    39    44    34    37    46    40    36    33    35    38    50    42    51    49    41    45    53    56

  Columns 23 through 44

    47    64    55    58    60    59    63    61    62    57    19    23    15    13     4    17    10     3     5     6     8     9

  Columns 45 through 64

     7     2    11     1    14    12    18    21    16    32    22    28    31    30    26    20    24    27    25    29



    11    16    22    20     7    12     2     5    14     8     4     1     3     6    18    10    19    17     9    13    21    24

  Columns 23 through 44

    15    32    23    26    28    27    31    29    30    25    51    55    47    45    36    49    42    35    37    38    40    41

  Columns 45 through 64

    39    34    43    33    46    44    50    53    48    64    54    60    63    62    58    52    56    59    57    61

	
	
	
	
A32_A1x32_Poly3_5mm_25s_177:
	
	   0     0     0     0     0     0     0     0     0     0     0     0     0     0     0     0    32    10    28    30    22     4    16

  Columns 24 through 46

    24    27    18    21    12     6    15     3     9     1    26    20    14     2     8    11     5    13    17    19    23    25    29

  Columns 47 through 64

    31     7     0     0     0     0     0     0     0     0     0     0     0     0     0     0     0     0
	
	
	
	  1    26    20    14     2     8    11     5    13    17    19    23    25    29    31     7     0     0     0     0     0     0     0

  Columns 24 through 46

    0     0     0     0     0     0     0     0     0     0     0     0     0     0     0     0     0     0     0     0     0     0     0

  Columns 47 through 64

    0     0    32    10    28    30    22     4    16    24    27    18    21    12     6    15     3     9






23    30     3    10    29     4    24    19    14     9    28     5    18    20    13    15    27     6    17    21    12    16    26     7    31    22

  Columns 27 through 32

    11     2    25     8    32     1


7    14    19    26    13    20     8     3    30    25    12    21     2     4    29    31    11    22     1     5    28    32    10    23    15     6

  Columns 27 through 32

    27    18     9    24    16    17
